----------------------------------------------------------------------------------------------------------------------------------------------------------------------------------------------------------
----------------------------------------------------------------------------------------------------------------------------------------------------------------------------------------------------------
---------------------------------------------------------------------------------------------------------------------------------------------------------------------------------------------------*------
--------------------------------------------------------------------------------***-----------------------------------------****-----------------------------------------------------------*---********---
-------------------------------------------------------------------------------**-***---*****--------------------------******---**-------------------------------------------------------*******------*---
-------------------------------------------------------------------------------*--g-****----****-----------------------*-***-----****----------------------------------------------------*--**--------*---
----------------------!--------------------------------------------------------*SSSSSSSS---SSS!**------------@--------**-SSS----S!!S*----------------------------------------------------*--##--------*---
----------------------*----------------------------------------------------*****--------------*-***----------*--------*----------**-**----****-----------***------------***-**-------*****-###--------*---
--------------------***---------------------***-****----***---------------**-**g--------------**********-----*------***----------***-*---**-***-------****-**---------***-******----**--**####--------*---
------------------**********---------*****-**-***--**-********--1---------*--**---------------*----**--*-----*-----****----------*****--**--***------**-*--**--------**----*--**-****---*#####--------*---
----------------!-*-S@S!S--*****----**---***--tt----****-tt--**-*----*****---S@S-----*****----C-----SU-**-!--!--!-**--S-----**-*-SS--****#--#***----***##--#**----****--SS!S-*****-**---######--------*---
----------------*-*-**-*--**---**---*-tt-**---tt-----*-*-tt---*-*---*---**----*-----*******---****---*--*-*--*--*-*---------**-*--*---**##--##***--**-###--##**--**-**----*--****--**--#######--------*---
----------------*-*-****-**-tt--**-**-tt-**---tt-----*-*-tt---***--**----***--*-----*-----**-******--*--****-*--*-*-------*************###--###**--*-####--###**-*-tt-*---*******--tt-########--------F---
---M*****************g****--tt---***--tt-g----tt-----g-g-tt----*****-----************-----*****g*g********k*****************gg*g-g---*####--####****#####--####***-tt-*******-gg---tt#########--------#---
XXXXXXXXXXXXXXXXXXXXXXXXXXXXXXXXXXXXXXXXXXXXXXXXXXXXXXXXXXXXXXXXXXXXX--XXXXXXXXXXXXXXX---XXXXXXXXXXXXXXXXXXXXXXXXXXXXXXXXXXXXXXXXXXXXXXXXXXXXXXXXXXXXXXXX--XXXXXXXXXXXXXXXXXXXXXXXXXXXXXXXXXXXXXXXXXXXXXXX
XXXXXXXXXXXXXXXXXXXXXXXXXXXXXXXXXXXXXXXXXXXXXXXXXXXXXXXXXXXXXXXXXXXXX--XXXXXXXXXXXXXXX---XXXXXXXXXXXXXXXXXXXXXXXXXXXXXXXXXXXXXXXXXXXXXXXXXXXXXXXXXXXXXXXX--XXXXXXXXXXXXXXXXXXXXXXXXXXXXXXXXXXXXXXXXXXXXXXX
